NO ./textures/north.xpm
SO ./textures/south.xpm
WE ./textures/west.xpm
EA ./textures/est.xpm
F 220, 100, 0
C 255, 255, 255

111111
100001
10S0N1
111111
