NO ./textures/north.xpm
SO ./textures/south.xpm
WE ./textures/west.xpm
EA ./textures/est.xpm
F 220, 100, 0
C 255, 255, 255

        1111111111111111111111111
        1000000001100000000000001
        1011000001110000000000001
        1001000000000000000000001
111111111011000001110000000000001
100000000011N00001110111111111111
11110111111111011100000010001
11110111111111011101010010001
11000000110101011100000010001
10000000000000001100000011111
1000000000000000110101001
1100000111010101110001111111111
11110111 1110101 100111010001
11111111 1111111 111111111111
