NO ./textures/north.xpm
SO ./textures/south.xpm
WE ./textures/west.xpm
EA ./textures/est.xpm
F 255, 200, 0
C 255, 100, 200


111111111111111
100100000001001
100100011101001
100000000000001
111100000001111
100001000000001
100001000001001
100001000000001
100001000000001
111111111000011111111111111111
100100000001001
100100011101001
100000000000001
111100000001111
100001000000001
100001000001001
100001000000001
100001000000001
111111000000011111111111111111
100100000001001
10010001110100110010000000111
100000000000001100100000001
1111000000011111001000000011
100001000000001
1000010000010011001000000011
100001000000001100100000001
100001000000001
111111000000011111111111111111
10010000000100010010000000000111111
100100011101000100100000000001
100000000000000000000000000001
111100000001110000000000000001
10000100000000W000000000000001111111
1000010000010000000000000000000111111111111111
10000100000000000010000000000000000100000001001
1000010000000001001000000000011111111111111111
111111111111111111111111111111