NO ./textures/north.xpm
SO ./textures/south.xpm
WE ./textures/west.xpm
EA ./textures/est.xpm
F 255, 200, 0
C 255, 100, 200


111111111111111
100100000001001
100100011101001
100000000000001
111100000001111
10000100W000001
100001000001001
100001000000001
100001000000001
111111111111111