NO ./textures/north.xpm
SO ./textures/south.xpm
WE ./textures/west.xpm
EA ./textures/est.xpm
F 220, 100, 0
C 255, 255, 255


11111111111111111111
11111111111N11111111
11111111111111111111
11111111111111111111
11111111111111111111
